##################v
>.......-.........*
#.#v##############.
#.#*............*#.
#|#.############.#|
#.#.#.*.*.*.*.!#.#.
#.#*.*.*.*.*.*.<.#.
#.##############.#.
>*...-...******....
#^################.
@.................*