...............***.
.############vvvv#.
..##:............#.
#..##########....#.
##@..............#.
...##########....#.
..##:.....-.#....#.
.##########.#....#.
.........##.#....#.
#..#######..#....#.
#~..........#||||#.
#..#############.!^
#^...............<#